BBBBBBBBBBBBBBBBBBBBBBBBBBBBBBBBBB
BPPPPPPPPPPPPPPPPPPPPWWWWWWWWWWWWB
BPPPPPPPPPPPPPPPPPPPPWWWWWWWWWWWWB
BPPPPPPPPPPPPPPPPPPPPWWWWWWWWWWWWB
BPPPPPPPPPPPPPPPPPPPPWWWWWWWWWWWWB
BPPPPPPPPPPPPPPPPPPPPWWWWWWWWWWWWB
BPPPPPPPPPPPPPPPPPPPPWWWWWWWWWWWWB
BPPPPPPPPPPPPPPPPPPPPWWWWWWWWWWWWB
BPPPPPPPPPPPPPPPPPPPPWWWWWWWWWWWWB
BPPPPPPPPPPPPPPPPPPPPPPPPPPPPPPPPB
BPPPPPPPPPPPPPPPPPPPPPPPPPPPPPPPPB
BPPPPPPPPPPPPPPPPPPPPPPPPPPPPPPPPB
BPPPPPPPPPPPPPPPPPPPPPPPPPPPPPPPPB
BPPPPPPPPPPPPPPPPPPPPPPPPPPPPPPPPB
BPPPPPPPPPPPPPPPPPPPPPPPPPPPPPPPPB
BPPPPPPPPPPPPPPPPPPPPPPPPPPPPPPPPB
BPPPPPPPPPPPPPPPPPPPPPPPPPPPPPPPPB
BWWWWWWWWWWWWPPPPPPPPCCPPPPPPPPPPB
BWWWWWWWWWWWWPPPPPPPPCCPPPPPPPPPPB
BWWWWWWWWWWWWPPPPPPPPPPPPPPPPPPPPB
BWWWWWWWWWWWWPPPPPPPPPPPPPPPPPPPPB
BWWWWWWWWWWWWPPPPPPPPPPPPPPPPPPPPB
BWWWWWWWWWWWWPPPPPPPPPPPPPPPPPPPPB
BWWWWWWWWWWWWPPPPPPPPPPPPPPPPPPPPB
BWWWWWWWWWWWWPPPPPPPPPPPPPPPPPPPPB
BWWWWWWWWWWWWPPPPPPPPPPPPPPPPPPPPB
BWWWWWWWWWWWWPPPPPPPPPPPPPPPPPPPPB
BWWWWWWWWWWWWPPPPPPPPPPPPPPPPPPPPB
BWWWWWWWWWWWWPPPPPPPPPPPPPPPPPPPPB
BBBBBBBBBBBBBBBBBBBBBBBBBBBBBBBBBB